11111111
1C0P1E01
1010C001
11111111
