11111111
1C0P0E01
10000001
11111111
