11111111
1C0PECC1
10000001
11111111
